1|1|1|1|2
2|1|2|1|2
3|1|1|2|1
4|1|1|4|2
5|1|3|5|1
6|1|1|5|2
